++++++++   +++++++++++
+   +   ++ ++   + +  +
      +     +  ++ ++++
+ +    ++  ++++ + + ++
+ +   + + +     + +  +
+          ++  +   + +
+ +++ + +      ++  + +
++ ++ + +  + +  ++   +
+          + +  + +  +
+++++ +  + + +   S   +
++++++++++++++++++++++